##############
#            #
##pb  0  #   #
#   #b   0 b #
#    0 #  #  #
##############