##########
#   ##   #
##pb  0  #
#      # #
##########