##########
#   ##   #
##p* #0  #
#      # #
##########